NO ./tests/docs/images/NO.xpm              
SO ./tests/docs/images/SO.xpm
WE ./tests/docs/images/WE.xpm
EA ./tests/docs/images/EA.xpm            

F 220,100,0                  
C 225,30,0

                    
       11111   11111   11111   11111
       10101   10101   10101   10101
       10101   10101   10101   10101
       10001   10001   10001   10001                         
       1000111110001   1000111110001
 1111111000000000001   1000000000001111111
 1000000000000000001   1000000000000000001
 11110000000000000011111000000000000011111
    10000000000000000000000000000000001             
 1111011000000000000EW00000000000000001111
 10000000000000000111111100000000000000001
 111111100000000001    1100000000001111111
       1000000000001  10000000000001
       100000000001    1000000000001                   
       1000000000001  10000000000001
 111111100000000001    1100000000001111111
 10000000000000000111111100000000000000001
 11110110000000000000000000000000000001111
    10000000000000000000000000000000001      
 11110000000000000011111000000000000011111               
 1000000000000000001   1000000000000000001
 1111111000000000001   1000000000001111111
       1000111110001   1000111110001
       10001   10001   10001   10001                         
       10101   10101   10101   10101
       10101   10101   10101   10101
       11111   11111   11111   11111


            

         