NO ./tests/docs/images/NO.xpm
SO ./tests/docs/images/SO.xpm
WE ./tests/docs/images/WE.xpm
EA ./tests/docs/images/EA.xpm

F 220,100,0
C 225,30,0

101011111   11
01001 10111110
11111 100    1
1  000001111 1
111 10 0100001
001 100001 100
N011011111 101